0,0,0,0,0,0,0,0,0,0,0,0,0,0,0,0,0,0,0,0,0,0,0,0,0,
0,0,0,0,0,0,0,0,0,0,0,0,0,0,0,0,0,0,0,0,0,0,0,0,0,
0,0,1,1,1,1,1,1,1,1,1,1,1,1,1,1,1,1,1,1,1,1,1,0,0,
0,0,1,3,2,0,0,0,0,0,0,0,0,0,0,0,0,0,0,3,0,0,1,0,0,
0,0,1,2,2,0,3,3,3,3,3,3,3,3,3,3,0,0,0,3,0,0,1,0,0,
0,0,1,0,0,0,0,0,0,0,0,0,0,0,0,0,0,0,0,3,0,0,1,0,0,
0,0,1,0,0,0,3,3,3,3,3,3,3,3,3,3,0,3,0,3,0,0,1,0,0,
0,0,1,3,0,0,3,0,0,0,3,0,0,0,3,3,0,0,0,3,0,3,1,0,0,
0,0,1,3,0,0,3,0,0,0,0,0,3,0,0,3,0,0,0,3,0,0,1,0,0,
1,0,1,0,0,0,3,0,3,3,3,3,3,3,0,3,0,0,3,3,0,0,1,0,0,
0,0,1,0,0,0,3,0,3,3,0,0,0,3,0,3,0,0,0,3,0,0,1,0,0,
0,0,1,0,0,0,3,0,3,3,0,3,0,3,0,3,3,0,0,3,0,0,1,0,0,
0,0,1,0,0,3,3,0,0,3,0,3,0,3,0,3,0,0,0,3,0,0,1,0,0,
0,0,1,0,0,3,3,0,0,3,0,3,0,3,0,3,0,0,0,3,0,0,1,0,0,
0,0,1,0,0,0,3,3,0,3,0,3,0,3,0,3,0,3,0,3,0,0,1,0,0,
0,0,1,0,0,0,3,3,0,3,0,3,0,3,0,3,0,0,0,3,0,0,1,0,0,
0,0,1,0,0,0,3,3,0,3,0,3,0,3,0,3,0,0,0,3,0,3,1,0,0,
0,0,1,0,0,3,3,0,0,3,0,3,0,3,0,3,3,0,0,3,0,0,1,0,0,
0,0,1,0,0,3,3,0,0,3,0,3,0,3,0,3,0,0,0,3,0,0,1,0,0,
0,0,1,0,0,0,3,0,3,3,0,3,0,3,0,3,0,0,3,3,0,0,1,0,0,
0,0,1,0,0,0,3,0,3,3,0,3,4,3,0,3,0,0,0,3,0,0,1,0,0,
0,0,1,0,0,0,3,0,3,3,0,3,3,3,0,3,0,0,0,3,0,0,1,0,0,
0,0,1,3,0,0,3,0,0,3,0,0,0,0,0,3,3,0,0,3,0,0,1,0,0,
0,0,1,3,0,0,3,0,0,3,3,3,3,3,3,3,0,0,0,3,0,0,1,0,0,
0,0,1,0,0,0,3,0,0,0,3,0,0,0,0,0,0,0,0,3,0,0,1,0,0,
0,0,1,0,0,0,3,3,0,0,0,0,0,3,0,0,0,3,0,3,0,3,1,0,0,
0,0,1,0,0,0,3,3,3,3,3,3,3,3,3,3,3,3,3,3,0,0,1,0,0,
0,0,1,0,0,0,0,0,0,0,0,0,0,3,0,0,0,0,0,0,0,0,1,0,0,
0,0,1,2,2,0,0,0,0,0,0,0,0,0,0,0,0,0,0,0,0,0,1,0,0,
0,0,1,3,2,0,0,0,0,3,0,0,0,0,0,0,0,3,0,0,0,0,1,0,0,
0,0,1,1,1,1,1,1,1,1,1,1,1,1,1,1,1,1,1,1,1,1,1,0,0,
0,0,0,0,0,0,0,0,0,0,0,0,0,0,0,0,0,0,0,0,0,0,0,0,0,
0,0,0,0,0,0,0,0,0,0,0,0,0,0,0,0,0,0,0,0,0,0,0,0,0,
0,0,0,0,0,0,0,0,0,0,0,0,0,0,0,0,0,0,0,0,0,0,0,0,0,
0,0,0,0,0,0,0,0,0,0,0,0,0,0,0,0,0,0,0,0,0,0,0,0,0,
0,0,0,0,0,0,0,0,0,0,0,0,0,0,0,0,0,0,0,0,0,0,0,0,0,
0,0,0,0,0,0,0,0,0,0,0,0,0,0,0,0,0,0,0,0,0,0,0,0,0,
